NO ./texturs/NO.png
SO ./texturs/SO.png
WE ./texturs/WE.png
EA ./texturs/EA.png

F 64,64,64
C 45,45,45


111111111
100000001
1000N0001
111111111