









NO ./texturs/NO.png
SO ./texturs/SO.png
WE ./texturs/WE.png
EA ./texturs/EA.png

F 64,64,64
C 45,45,45


11111111111111111111111111   1111
111111111111111111111111111111N1
111                         11111