NO ./texturs/NO.png
SO ./texturs/SO.png
WE ./texturs/WE.png
EA ./texturs/EA.png

F 6,160,122
C 211,211,211

        1111111111111111111111111
        1000000000110000000000001
        1011000001110000000000001
        1001000000000000000000001
111111111011000001110000000000001
100000000011000001110111101111111
11110111111111011100000010001
11110111111111011101010010001
11000000110101011100000010001
1000000000000001100000010001
100000000000000011010100100011111111111111111111111111111111111111111111
1100000111010101111101111000000E000000000000000000000000000000000000001
11110111 1110101 1011110100011111111111111111111111111111111111111111111
11111111 1111111 111111111111
11111111 1111111 111111111111