NO ./path_to_the_north_texture
SO ./path_to_the_south_texture
WE ./path_to_the_west_texture
EA ./path_to_the_east_texture

F 220,100,0
C 225,30,0

            111
            101
            101111111111111111111111111
            100000000000000000000000011
            101111111111111111111111111
            101
            101
11111111111110111111111111
100000000000000000N00000011
11111111111110111111111111
            101
            101
            101111111111111111111111111
            100000000000000000000000011
            101111111111111111111111111
111111111111101
100000000000001
111111111111101
            111