NO ./texturs/NO.png
SO ./texturs/SO.png
WE ./texturs/WE.png
EA ./texturs/EA.png

F 64,64,64
C 45,45,45

        11111111111111111111111111
        10000000001100010D0000D0D01
        101100000111000101111110101
        10010000000D000D0111111D101
111111111D11D11111110001100D00001D1
10000000001100000111D1111D111111101
11110111111111011100000010001   101
11110111111111011101010010001   101
11000000110101011101D11111D111111D1
1000000000000001000100000100D0D0001
1000000000000100110101111100111D1D11
1100000111D111D111D1D110D0110D0N0001
11110111 1000000D0000000100001111111
11111111 111111111111111111111111111
