NO ./texturs/NO.png
SO ./texturs/SO.png
WE ./texturs/WE.png
EA ./texturs/EA.png


F 255,160,122
C 211,211,211

        11111111111111111111111111
        10000000001100010D0000D0D01
        101100000111000101111110101
        10010000000D000D0111111D101
111111111D11D11111110001100D00001D1
10000000001100000111D1111D111111101
11110111111111011100000010001   101
11110111111111011101010010001   101
11000000110101011101D11111D111111D111
1000000000000010000100000100D0D0001
1000000000000100110101111100111D1D111
1100000111D111D111D1D110D0110D0N00001
11110111 1000000D00000011000011111111
11111111 1111111111111111111111111111
